PRD
An Interactive Fiction by func_door
Release 1 / Serial number 140918 / Inform 7 build 6L02 (I6/v6.33 lib 6/12N) SD

Staging Area
You can see PC2, PC3 and PC4 here.

* * *

>north
Test Chamber
You can see Alice, Bob, Carol and Dan here.

Beginning combat!

Enemy: Alice, Bob, Carol and Dan.
Your Party: PC1, pc2, pc3 and pc4.

What will PC1 do?

>use bubble
okay, PC1 will use Bubble on PC1!

What will pc2 do?

>use bubble
okay, pc2 will use Bubble on pc2!

What will pc3 do?

>use bubble
okay, pc3 will use Bubble on pc3!

What will pc4 do?

>use bubble
okay, pc4 will use Bubble on pc4!

Initiative: Alice, Bob, Carol, Dan, pc4, pc3, pc2 and PC1.

pc4 uses Bubble on Carol and Dan!
calculating core damage with attack 37, defense 10, power 40.
maximum mid-calculation value: 17760.
before modifiers: 37.
modified by type effectiveness: 37.
modified by random variation: 31.
calculating core damage with attack 37, defense 10, power 40.
maximum mid-calculation value: 17760.
before modifiers: 37.
modified by type effectiveness: 37.
modified by random variation: 32.

pc3 uses Bubble on Bob, Carol and Dan!
calculating core damage with attack 70, defense 10, power 40.
maximum mid-calculation value: 61600.
before modifiers: 125.
modified by type effectiveness: 125.
modified by random variation: 121.
calculating core damage with attack 70, defense 10, power 40.
maximum mid-calculation value: 61600.
before modifiers: 125.
modified by type effectiveness: 125.
modified by random variation: 120.
calculating core damage with attack 70, defense 10, power 40.
maximum mid-calculation value: 61600.
before modifiers: 125.
modified by type effectiveness: 125.
modified by random variation: 125.

pc2 uses Bubble on Alice, Bob and Carol!
calculating core damage with attack 135, defense 10, power 40.
maximum mid-calculation value: 226800.
before modifiers: 455.
modified by type effectiveness: 455.
modified by random variation: 434.
calculating core damage with attack 135, defense 10, power 40.
maximum mid-calculation value: 226800.
before modifiers: 455.
modified by type effectiveness: 455.
modified by random variation: 411.
calculating core damage with attack 135, defense 10, power 40.
maximum mid-calculation value: 226800.
before modifiers: 455.
modified by type effectiveness: 455.
modified by random variation: 401.

PC1 uses Bubble on Alice and Bob!
calculating core damage with attack 540, defense 10, power 40.
maximum mid-calculation value: 907200.
before modifiers: 1816.
modified by type effectiveness: 1816.
modified by random variation: 1762.
calculating core damage with attack 540, defense 10, power 40.
maximum mid-calculation value: 907200.
before modifiers: 1816.
modified by type effectiveness: 1816.
modified by random variation: 1720.

== New Combat Round ==Enemy: Alice, Bob, Carol and Dan.
Your Party: PC1, pc2, pc3 and pc4.

What will PC1 do?

>use bubble
okay, PC1 will use Bubble on PC1!

What will pc2 do?

* * *

>use bubble
okay, pc3 will use Bubble on pc3!

What will pc4 do?

>use bubble
okay, pc4 will use Bubble on pc4!

Initiative: Alice, Bob, Carol, Dan, pc4, pc3, pc2 and PC1.

pc4 uses Bubble on Carol and Dan!
calculating core damage with attack 37, defense 10, power 40.
maximum mid-calculation value: 17760.
before modifiers: 37.
modified by type effectiveness: 37.
modified by random variation: 36.
calculating core damage with attack 37, defense 10, power 40.
maximum mid-calculation value: 17760.
before modifiers: 37.
modified by type effectiveness: 37.
modified by random variation: 37.

pc3 uses Bubble on Bob, Carol and Dan!
calculating core damage with attack 70, defense 10, power 40.
maximum mid-calculation value: 61600.
before modifiers: 125.
modified by type effectiveness: 125.
modified by random variation: 123.
calculating core damage with attack 70, defense 10, power 40.
maximum mid-calculation value: 61600.
before modifiers: 125.
modified by type effectiveness: 125.
modified by random variation: 123.
calculating core damage with attack 70, defense 10, power 40.
maximum mid-calculation value: 61600.
before modifiers: 125.
modified by type effectiveness: 125.
modified by random variation: 121.

pc2 uses Bubble on Alice, Bob and Carol!
calculating core damage with attack 135, defense 10, power 40.
maximum mid-calculation value: 226800.
before modifiers: 455.
modified by type effectiveness: 455.
modified by random variation: 441.
calculating core damage with attack 135, defense 10, power 40.
maximum mid-calculation value: 226800.
before modifiers: 455.
modified by type effectiveness: 455.
modified by random variation: 437.
calculating core damage with attack 135, defense 10, power 40.
maximum mid-calculation value: 226800.
before modifiers: 455.
modified by type effectiveness: 455.
modified by random variation: 416.
SelfStat: false.
RaiseStat: false.
StatMod: 256.
0 0 0 0 1 0 0.
Carol's Speed dropped by 1!

PC1 uses Bubble on Alice and Bob!
calculating core damage with attack 540, defense 10, power 40.
maximum mid-calculation value: 907200.
before modifiers: 1816.
modified by type effectiveness: 1816.
modified by random variation: 1656.
calculating core damage with attack 540, defense 10, power 40.
maximum mid-calculation value: 907200.
before modifiers: 1816.
modified by type effectiveness: 1816.
modified by random variation: 1751.

== New Combat Round ==Enemy: Alice, Bob, Carol and Dan.
Your Party: PC1, pc2, pc3 and pc4.

What will PC1 do?

* * *

PRD
An Interactive Fiction by func_door
Release 1 / Serial number 140918 / Inform 7 build 6L02 (I6/v6.33 lib 6/12N) SD

Staging Area
You can see PC2, PC3 and PC4 here.

>turn myself into hitmonchan
I only understood you as far as wanting to turn yourself.

* * *

>north
Test Chamber
You can see a Monster here.

Beginning combat!

What will PC1 do?

>use bullet punch on monster
okay, PC1 will use Bullet Punch on the Monster!

What will pc2 do?

>use bullet punch on monster
okay, pc2 will use Bullet Punch on the Monster!

What will pc3 do?

>use bullet punch on monster
okay, pc3 will use Bullet Punch on the Monster!

What will pc4 do?

>use bullet punch on monster
okay, pc4 will use Bullet Punch on the Monster!

Initiative: Monster, pc4, pc3, pc2 and PC1.

pc4 uses Bullet Punch on the Monster!
calculating core damage with attack 29, defense 11, power 40.
maximum mid-calculation value: 13920.
before modifiers: 27.
modified by type effectiveness: 27.
modified by random variation: 22.
SelfStat: false.
RaiseStat: false.
StatMod: 0.
0 0 0 0 0 0 0.

pc3 uses Bullet Punch on the Monster!
calculating core damage with attack 54, defense 11, power 40.
maximum mid-calculation value: 47520.
before modifiers: 88.
modified by type effectiveness: 88.
modified by random variation: 80.
SelfStat: false.
RaiseStat: false.
StatMod: 0.
0 0 0 0 0 0 0.

pc2 uses Bullet Punch on the Monster!
calculating core damage with attack 103, defense 11, power 40.
maximum mid-calculation value: 173040.
before modifiers: 316.
modified by type effectiveness: 316.
modified by random variation: 277.
SelfStat: false.
RaiseStat: false.
StatMod: 0.
0 0 0 0 0 0 0.

PC1 uses Bullet Punch on the Monster!
calculating core damage with attack 215, defense 11, power 40.
maximum mid-calculation value: 361200.
before modifiers: 658.
modified by type effectiveness: 658.
modified by random variation: 584.
SelfStat: false.
RaiseStat: false.
StatMod: 0.
0 0 0 0 0 0 0.

What will PC1 do?

* * *

PRD
An Interactive Fiction by func_door
Release 1 / Serial number 140918 / Inform 7 build 6L02 (I6/v6.33 lib 6/12N) SD

Staging Area
You can see PC2, PC3 and PC4 here.

>verbose combat
Enabling verbose combat.

>north
Test Chamber
You can see Alice, Bob, Carol and Dan here.

Beginning combat!

     Enemy: Alice     Bob       Carol     Dan       
Your Party: PC1       PC2       PC3       PC4       

What will PC1 (29/29) do?

>use toxic on alice
okay, PC1 will use Toxic on Alice!

What will PC2 (29/29) do?

>use toxic on bob
okay, PC2 will use Toxic on Bob!

What will PC3 (29/29) do?

>use toxic on carol
okay, PC3 will use Toxic on Carol!

What will PC4 (29/29) do?

>use toxic on dan
okay, PC4 will use Toxic on Dan!

Initiative: PC4, PC3, PC2, PC1, Alice, Bob, Carol and Dan.

PC4 uses Toxic on Dan!
Move accuracy 90, modified by accuracy 0 and evasion 0 is 90.
crit chance level is 0.
Dan is inflicted with BadPoisoned!

PC3 uses Toxic on Carol!
Move accuracy 90, modified by accuracy 0 and evasion 0 is 90.
crit chance level is 0.
Carol is inflicted with BadPoisoned!

PC2 uses Toxic on Bob!
Move accuracy 90, modified by accuracy 0 and evasion 0 is 90.
crit chance level is 0.
Bob is inflicted with BadPoisoned!

PC1 uses Toxic on Alice!
Move accuracy 90, modified by accuracy 0 and evasion 0 is 90.
crit chance level is 0.
Alice is inflicted with BadPoisoned!

Alice uses Bite on PC2!
Move accuracy 100, modified by accuracy 0 and evasion 0 is 100.
crit chance level is 0.
calculating core damage with attack 8, defense 14, power 60.
before modifiers: 4.
modified by type effectiveness: 4.
modified by random variation: 3.
PC2 is damaged for 3 (100% -> 90%)
PC2 is inflicted with Flinching!

Bob uses Bite on PC2!
Move accuracy 100, modified by accuracy 0 and evasion 0 is 100.
crit chance level is 0.
calculating core damage with attack 8, defense 14, power 60.
before modifiers: 4.
modified by type effectiveness: 4.
modified by random variation: 4.
PC2 is damaged for 4 (90% -> 76%)

Carol uses Bite on PC2!
Move accuracy 100, modified by accuracy 0 and evasion 0 is 100.
crit chance level is 0.
calculating core damage with attack 8, defense 14, power 60.
before modifiers: 4.
modified by type effectiveness: 4.
modified by random variation: 3.
PC2 is damaged for 3 (76% -> 66%)

Dan uses Bite on PC2!
Move accuracy 100, modified by accuracy 0 and evasion 0 is 100.
crit chance level is 0.
calculating core damage with attack 8, defense 14, power 60.
before modifiers: 4.
modified by type effectiveness: 4.
Damage modified to 6; 
It's a critical hit!
PC2 is damaged for 6 (66% -> 45%)
PC2 is inflicted with Flinching!

Alice dissolves from strong poison!
Alice is damaged for 1 (100% -> 94%)
Bob dissolves from strong poison!
Bob is damaged for 1 (100% -> 94%)
Carol dissolves from strong poison!
Carol is damaged for 1 (100% -> 94%)
Dan dissolves from strong poison!
Dan is damaged for 1 (100% -> 94%)

== Starting Round 2 ==
     Enemy: Alice     Bob       Carol     Dan       
Your Party: PC1       PC2       PC3       PC4       

What will PC1 (29/29) do?

>use toxic on dan
PC1 can't reach Dan with Toxic!

What will PC1 (29/29) do?

>use toxic on alice
okay, PC1 will use Toxic on Alice!

What will PC2 (13/29) do?

>use toxic on carol
okay, PC2 will use Toxic on Carol!

What will PC3 (29/29) do?

>use toxic on bob
okay, PC3 will use Toxic on Bob!

What will PC4 (29/29) do?

>use toxic on dan
okay, PC4 will use Toxic on Dan!

Initiative: PC4, PC3, PC2, PC1, Alice, Bob, Carol and Dan.

PC4 uses Toxic on Dan!
Move accuracy 90, modified by accuracy 0 and evasion 0 is 90.
crit chance level is 0.

PC3 uses Toxic on Bob!
Move accuracy 90, modified by accuracy 0 and evasion 0 is 90.
91 is greater than 90! 
Move misses!
crit chance level is 0.

PC2 uses Toxic on Carol!
Move accuracy 90, modified by accuracy 0 and evasion 0 is 90.
crit chance level is 0.

PC1 uses Toxic on Alice!
Move accuracy 90, modified by accuracy 0 and evasion 0 is 90.
crit chance level is 0.

Alice uses Bite on PC2!
Move accuracy 100, modified by accuracy 0 and evasion 0 is 100.
crit chance level is 0.
calculating core damage with attack 8, defense 14, power 60.
before modifiers: 4.
modified by type effectiveness: 4.
Damage modified to 6; 
It's a critical hit!
PC2 is damaged for 6 (45% -> 24%)
PC2 is inflicted with Flinching!

Bob uses Bite on PC2!
Move accuracy 100, modified by accuracy 0 and evasion 0 is 100.
crit chance level is 0.
calculating core damage with attack 8, defense 14, power 60.
before modifiers: 4.
modified by type effectiveness: 4.
modified by random variation: 4.
PC2 is damaged for 4 (24% -> 10%)

Carol uses Bite on PC2!
Move accuracy 100, modified by accuracy 0 and evasion 0 is 100.
crit chance level is 0.
calculating core damage with attack 8, defense 14, power 60.
before modifiers: 4.
modified by type effectiveness: 4.
modified by random variation: 3.
PC2 is damaged for 3 (10% -> 0%)

Dan uses Bite on PC2!
Move accuracy 100, modified by accuracy 0 and evasion 0 is 100.
crit chance level is 0.
calculating core damage with attack 8, defense 14, power 60.
before modifiers: 4.
modified by type effectiveness: 4.
modified by random variation: 4.
PC2 is damaged for 4 (0% -> 0%)

Alice dissolves from strong poison!
Alice is damaged for 2 (94% -> 82%)
Bob dissolves from strong poison!
Bob is damaged for 2 (94% -> 82%)
Carol dissolves from strong poison!
Carol is damaged for 2 (94% -> 82%)
Dan dissolves from strong poison!
Dan is damaged for 2 (94% -> 82%)

== Starting Round 3 ==
     Enemy: Alice     Bob       Carol     Dan       
Your Party: PC1       PC2       PC3       PC4       

What will PC1 (29/29) do?

>wait
Time passes.

What will PC1 (29/29) do?

* * *

>verbose combat
Enabling verbose combat.

>verbose combat
Disabling verbose combat.

>north
Test Chamber
You can see Alice, Bob, Carol and Dan here.

Beginning combat!

     Enemy: Alice     Bob       Carol     Dan       
Your Party: PC1       PC2       PC3       PC4       

What will PC1 (29/29) do?

>verbose combat
Enabling verbose combat.

What will PC1 (29/29) do?

* * *

PRD
An Interactive Fiction by func_door
Release 1 / Serial number 140918 / Inform 7 build 6L02 (I6/v6.33 lib 6/12N) SD

Staging Area
You can see PC2, PC3 and PC4 here.

>use substitute
Obvious exits: north

>north
Test Chamber
You can see Alice, Bob, Carol and Dan here.

Beginning combat!

     Enemy: Alice     Bob       Carol     Dan       
Your Party: PC1       PC2       PC3       PC4       

Obvious exits: south 
What will PC1 (29/29) do?

>north
You must USE <some move you know> ON <some target in this battle>

Obvious exits: south 
What will PC1 (29/29) do?

>use substitute
okay, PC1 will use Substitute on PC1!

Obvious exits: south 
What will PC2 (29/29) do?

>use substitute
okay, PC2 will use Substitute on PC2!

Obvious exits: south 
What will PC3 (29/29) do?

>use substitute
okay, PC3 will use Substitute on PC3!

Obvious exits: south 
What will PC4 (29/29) do?

>use substitute
okay, PC4 will use Substitute on PC4!

Initiative: PC4, PC3, PC2, PC1, Alice, Bob, Carol and Dan.

PC4 uses Substitute on PC4!
PC4 uses a substitute!
PC4 is damaged for 7 (100% -> 76%)

PC3 uses Substitute on PC3!
PC3 uses a substitute!
PC3 is damaged for 7 (100% -> 76%)

PC2 uses Substitute on PC2!
PC2 uses a substitute!
PC2 is damaged for 7 (100% -> 76%)

PC1 uses Substitute on PC1!
PC1 uses a substitute!
PC1 is damaged for 7 (100% -> 76%)

Alice uses Bite on PC2!
It's a critical hit!
PC2's substitute breaks!

Bob uses Bite on PC2!
PC2 is damaged for 3 (76% -> 66%)

Carol uses Bite on PC2!
PC2 is damaged for 3 (66% -> 55%)

Dan uses Bite on PC2!
PC2 is damaged for 3 (55% -> 45%)

== Starting Round 2 ==
     Enemy: Alice     Bob       Carol     Dan       
Your Party: PC1       PC2       PC3       PC4       

Obvious exits: south 
What will PC1 (22/29) do?

>use bulk up
okay, PC1 will use Bulk Up on PC1!

Obvious exits: south 
What will PC2 (13/29) do?

>use bulk up
okay, PC2 will use Bulk Up on PC2!

Obvious exits: south 
What will PC3 (22/29) do?

>use bulk up
okay, PC3 will use Bulk Up on PC3!

Obvious exits: south 
What will PC4 (22/29) do?

>use bulk up
okay, PC4 will use Bulk Up on PC4!

Initiative: PC4, PC3, PC2, PC1, Alice, Bob, Carol and Dan.

PC4 uses Bulk Up on PC4!

PC3 uses Bulk Up on PC3!

PC2 uses Bulk Up on PC2!
PC2's Physical Attack and Physical Defense rose by 1!

PC1 uses Bulk Up on PC1!

Alice uses Bite on PC2!
PC2 is damaged for 3 (45% -> 34%)

Bob uses Bite on PC2!
PC2 is damaged for 3 (34% -> 24%)

Carol uses Bite on PC2!
PC2 is damaged for 2 (24% -> 17%)

Dan uses Bite on PC2!
PC2 is damaged for 2 (17% -> 10%)

== Starting Round 3 ==
     Enemy: Alice     Bob       Carol     Dan       
Your Party: PC1       PC2       PC3       PC4       

Obvious exits: south 
What will PC1 (22/29) do?

>showme pc2
PC2 - Player Character
location: in Test Chamber
singular-named, proper-named; unlit, inedible, portable; male; ready-for-orders
printed name: "PC2"
printed plural name: "Player Characters"
indefinite article: none
description: none
initial appearance: none
carrying capacity: 100
Ability Slot: 1
Third Type: NoType
Second Type: NoType
First Type: NoType
Level: 10
Current Hit Points: 3
EvadeMod: 0
AccMod: 0
SpeedMod: 0
SpecDefMod: 0
SpecAttMod: 0
PhysDefMod: 1
PhysAttMod: 1
Queued Action: PC2 using Bulk Up on PC2
StatusProblem: NullStatus
BadPoisonCounter: 0
SleepCounter: 0
cond_flinch: false
cond_confusion: 0
cond_Substitute: -2
LinePos: 2
Priority: 0
InitiativeOrder: 14
PokeAbility: Stench
Alignment: Friendly
PokeSpecies: Bulbasaur
Experience: 0
SXP: 0
SDXP: 0
PDXP: 0
SAXP: 0
PAXP: 0
HPXP: 0

What will PC1 (22/29) do?

* * *

PRD
An Interactive Fiction by func_door
Release 1 / Serial number 140918 / Inform 7 build 6L02 (I6/v6.33 lib 6/12N) SD

Staging Area
You can see PC2, PC3 and PC4 here.

>north
Test Chamber
You can see Alice, Bob, Carol and Dan here.

Beginning combat!

     Enemy: Alice     Bob       Carol     Dan       
Your Party: PC1       PC2       PC3       PC4       

What will PC1 (29/29) do?

>use leech seed on bob
okay, PC1 will use Leech Seed on Bob!

What will PC2 (29/29) do?

>use bulk up
okay, PC2 will use Bulk Up on PC2!

What will PC3 (29/29) do?

>use bulk up
okay, PC3 will use Bulk Up on PC3!

What will PC4 (29/29) do?

>use bulk up
okay, PC4 will use Bulk Up on PC4!

PC4 uses Bulk Up!
PC4's Physical Attack and Physical Defense rose by 1!

PC3 uses Bulk Up!
PC3's Physical Attack and Physical Defense rose by 1!

PC2 uses Bulk Up!
PC2's Physical Attack and Physical Defense rose by 1!

PC1 uses Leech Seed on Bob!

Alice uses Bite on PC2!
PC2 is damaged for 3 (100% -> 90%)

Bob uses Bite on PC2!
PC2 is damaged for 2 (90% -> 83%)

Carol uses Bite on PC2!
PC2 is damaged for 3 (83% -> 72%)

Dan uses Bite on PC2!
PC2 is damaged for 2 (72% -> 66%)

Bob is harmed by its leech seeed, healing PC2!
Bob is damaged for 2 (100% -> 88%)
PC2 is healed for 2 (66% -> 72%)

== Starting Round 2 ==
     Enemy: Alice     Bob       Carol     Dan       
Your Party: PC1       PC2       PC3       PC4       

What will PC1 (29/29) do?

* * *

>use leech seed on bob
okay, PC1 will use Leech Seed on Bob!

What will PC2 (29/29) do?

>wait
You must USE <some move you know> ON <some target in this battle>

What will PC2 (29/29) do?

>bulk up
That's not a verb I recognise.

What will PC2 (29/29) do?

>use bulk up
okay, PC2 will use Bulk Up on PC2!

What will PC3 (29/29) do?

* * *

>use bulk up
okay, PC3 will use Bulk Up on PC3!

What will PC4 (29/29) do?

>use bulk up
okay, PC4 will use Bulk Up on PC4!

PC4 uses Bulk Up!
PC4's Physical Attack and Physical Defense rose by 1!

PC3 uses Bulk Up!
PC3's Physical Attack and Physical Defense rose by 1!

PC2 uses Bulk Up!
PC2's Physical Attack and Physical Defense rose by 1!

PC1 uses Leech Seed on Bob!
Move misses!

Alice uses Bite on PC2!
It's a critical hit!
PC2 is damaged for 4 (100% -> 86%)

Bob uses Bite on PC2!
PC2 is damaged for 2 (86% -> 79%)

Carol uses Bite on PC2!
PC2 is damaged for 2 (79% -> 72%)

Dan uses Bite on PC2!
PC2 is damaged for 3 (72% -> 62%)

== Starting Round 2 ==
     Enemy: Alice     Bob       Carol     Dan       
Your Party: PC1       PC2       PC3       PC4       

What will PC1 (29/29) do?

>showme pc1
There seems to be no such object anywhere in the model world.

What will PC1 (29/29) do?

* * *

>north
Test Chamber
You can see Alice, Bob, Carol and Dan here.

Beginning combat!

     Enemy: Alice     Bob       Carol     Dan       
Your Party: PC1       PC2       PC3       PC4       

What will PC1 (29/29) do?

>wait
You must USE <some move you know> ON <some target in this battle>

What will PC1 (29/29) do?

>use bulk up
okay, PC1 will use Bulk Up on PC1!

What will PC2 (29/29) do?

>use bulk up
okay, PC2 will use Bulk Up on PC2!

What will PC3 (29/29) do?

* * *

>use bulk up
okay, PC3 will use Bulk Up on PC3!

What will PC4 (29/29) do?

>use bulk up
okay, PC4 will use Bulk Up on PC4!

PC4 uses Bulk Up!
PC4's Physical Attack and Physical Defense rose by 1!

PC3 uses Bulk Up!
PC3's Physical Attack and Physical Defense rose by 1!

PC2 uses Bulk Up!
PC2's Physical Attack and Physical Defense rose by 1!

PC1 uses Bulk Up!
PC1's Physical Attack and Physical Defense rose by 1!

Alice uses Bite!
Alice is damaged for 5 (100% -> 71%)

Bob uses Bite!
Bob is damaged for 4 (100% -> 76%)

Carol uses Bite!
Carol is damaged for 5 (100% -> 71%)

Dan uses Bite!
Dan is damaged for 4 (100% -> 76%)

== Starting Round 2 ==
     Enemy: Alice     Bob       Carol     Dan       
Your Party: PC1       PC2       PC3       PC4       

What will PC1 (29/29) do?

* * *

>north
Test Chamber
You can see Alice, Bob, Carol and Dan here.

Beginning combat!

     Enemy: Alice     Bob       Carol     Dan       
Your Party: PC1       PC2       PC3       PC4       

What will PC1 (29/29) do?

>bulk up
That's not a verb I recognise.

What will PC1 (29/29) do?

>use bulk up
okay, PC1 will use Bulk Up on PC1!

What will PC2 (29/29) do?

* * *

>use bulk up
okay, PC3 will use Bulk Up on PC3!

What will PC4 (29/29) do?

>use bulk up
okay, PC4 will use Bulk Up on PC4!

PC4 uses Bulk Up!
PC4's Physical Attack and Physical Defense rose by 1!

PC3 uses Bulk Up!
PC3's Physical Attack and Physical Defense rose by 1!

PC2 uses Bulk Up!
PC2's Physical Attack and Physical Defense rose by 1!

PC1 uses Bulk Up!
PC1's Physical Attack and Physical Defense rose by 1!

== Starting Round 2 ==
     Enemy: Alice     Bob       Carol     Dan       
Your Party: PC1       PC2       PC3       PC4       

What will PC1 (29/29) do?

* * *

>bulk up
That's not a verb I recognise.

What will PC1 (29/29) do?

>bulk up
That's not a verb I recognise.

What will PC1 (29/29) do?

* * *

>north
Test Chamber
You can see Alice, Bob, Carol and Dan here.

Beginning combat!

     Enemy: Alice     Bob       Carol     Dan       
Your Party: PC1       PC2       PC3       PC4       

What will PC1 (29/29) do?

>use bite on alice
okay, PC1 will use Bite on Alice!

What will PC2 (29/29) do?

>use bite on bob
okay, PC2 will use Bite on Bob!

What will PC3 (29/29) do?

>use bite on carol
okay, PC3 will use Bite on Carol!

What will PC4 (29/29) do?

>use bite on dan
okay, PC4 will use Bite on Dan!

PC4 uses Bite on Dan!
Dan is damaged for 11 (100% -> 35%)

PC3 uses Bite on Carol!
Carol is damaged for 13 (100% -> 24%)

PC2 uses Bite on Bob!
Bob is damaged for 14 (100% -> 18%)

PC1 uses Bite on Alice!
Alice is damaged for 12 (100% -> 29%)

Alice uses Milk Drink!
Alice is healed for 8 (29% -> 76%)

Bob uses Milk Drink!
Bob is healed for 8 (18% -> 65%)

Carol Flinched and couldn't act!

Dan uses Milk Drink!
Dan is healed for 8 (35% -> 82%)

== Starting Round 2 ==
     Enemy: Alice     Bob       Carol     Dan       
Your Party: PC1       PC2       PC3       PC4       

What will PC1 (29/29) do?

>use bite on alice
okay, PC1 will use Bite on Alice!

What will PC2 (29/29) do?

* * *

>use bite on carol
okay, PC3 will use Bite on Carol!

What will PC4 (29/29) do?

>use heal block
okay, PC4 will use Heal Block on PC4!

PC4 uses Heal Block!
Heal Block prevents healing!
Heal Block prevents healing!
Heal Block prevents healing!
Heal Block prevents healing!

PC3 uses Bite on Carol!
Carol is damaged for 12 (71% -> 0%)
Heal Block prevents healing!

PC2 uses Bite on Bob!
Bob is damaged for 13 (82% -> 6%)
Heal Block prevents healing!

PC1 uses Bite on Alice!
Alice is damaged for 11 (82% -> 18%)
Heal Block prevents healing!

Alice uses Milk Drink!
Heal Block prevents healing!
Heal Block prevents healing!

Bob uses Milk Drink!
Heal Block prevents healing!
Heal Block prevents healing!

Carol uses Milk Drink!
Heal Block prevents healing!
Heal Block prevents healing!

Dan uses Milk Drink!
Heal Block prevents healing!
Heal Block prevents healing!

== Starting Round 3 ==
     Enemy: Alice     Bob       Carol     Dan       
Your Party: PC1       PC2       PC3       PC4       

What will PC1 (29/29) do?

* * *

>use bite on carol
okay, PC3 will use Bite on Carol!

What will PC4 (29/29) do?

>use heal block
okay, PC4 will use Heal Block on PC4!

PC4 uses Heal Block!

PC3 uses Bite on Carol!
Carol is damaged for 14 (100% -> 18%)

PC2 uses Bite on Bob!
Bob is damaged for 11 (100% -> 35%)

PC1 uses Bite on Alice!
Alice is damaged for 11 (100% -> 35%)

== Starting Round 2 ==
     Enemy: Alice     Bob       Carol     Dan       
Your Party: PC1       PC2       PC3       PC4       

What will PC1 (29/29) do?

>showme alice
Alice - Monster
location: in Test Chamber
singular-named, proper-named; unlit, inedible, portable; male
printed name: "Alice"
printed plural name: "Monsters"
indefinite article: none
description: none
initial appearance: none
carrying capacity: 100
Ability Slot: 1
Third Type: NoType
Second Type: NoType
First Type: NoType
Level: 4
Current Hit Points: 6
EvadeMod: 0
AccMod: 0
SpeedMod: 0
SpecDefMod: 0
SpecAttMod: 0
PhysDefMod: 0
PhysAttMod: 0
Queued Action: Alice using Milk Drink on nothing
StatusProblem: NullStatus
BadPoisonCounter: 0
SleepCounter: 0
cond_flinch: false
cond_confusion: 0
LinePos: 1
Priority: 0
InitiativeOrder: 8
cond_HealBlock: 4
cond_LeechSeed: false
cond_Substitute: 0
cond_LightScreen: 0
cond_Reflect: 0
PokeAbility: Stench
Alignment: Neutral
PokeSpecies: Bulbasaur

What will PC1 (29/29) do?

>use bulk up
okay, PC1 will use Bulk Up on PC1!

What will PC2 (29/29) do?

* * *

>use bulk up
okay, PC3 will use Bulk Up on PC3!

What will PC4 (29/29) do?

>use bulk up
okay, PC4 will use Bulk Up on PC4!

PC4 uses Bulk Up!
PC4's Physical Attack and Physical Defense rose by 1!

PC3 uses Bulk Up!
PC3's Physical Attack and Physical Defense rose by 1!

PC2 uses Bulk Up!
PC2's Physical Attack and Physical Defense rose by 1!

PC1 uses Bulk Up!
PC1's Physical Attack and Physical Defense rose by 1!

== Starting Round 3 ==
     Enemy: Alice     Bob       Carol     Dan       
Your Party: PC1       PC2       PC3       PC4       

What will PC1 (29/29) do?

>verbose combat
Enabling verbose combat.

What will PC1 (29/29) do?

>use bulk up
okay, PC1 will use Bulk Up on PC1!

What will PC2 (29/29) do?

* * *

>use bulk up
okay, PC3 will use Bulk Up on PC3!

What will PC4 (29/29) do?

>use bulk up
okay, PC4 will use Bulk Up on PC4!

Initiative: PC4, PC3, PC2, PC1, Alice, Bob, Carol and Dan.

PC4 uses Bulk Up!
Move accuracy 0.
crit chance level is 0.
PC4's Physical Attack and Physical Defense rose by 1!

PC3 uses Bulk Up!
Move accuracy 0.
crit chance level is 0.
PC3's Physical Attack and Physical Defense rose by 1!

PC2 uses Bulk Up!
Move accuracy 0.
crit chance level is 0.
PC2's Physical Attack and Physical Defense rose by 1!

PC1 uses Bulk Up!
Move accuracy 0.
crit chance level is 0.
PC1's Physical Attack and Physical Defense rose by 1!

== Starting Round 4 ==
     Enemy: Alice     Bob       Carol     Dan       
Your Party: PC1       PC2       PC3       PC4       

What will PC1 (29/29) do?

>showme alice
Alice - Monster
location: in Test Chamber
singular-named, proper-named; unlit, inedible, portable; male
printed name: "Alice"
printed plural name: "Monsters"
indefinite article: none
description: none
initial appearance: none
carrying capacity: 100
Ability Slot: 1
Third Type: NoType
Second Type: NoType
First Type: NoType
Level: 4
Current Hit Points: 6
EvadeMod: 0
AccMod: 0
SpeedMod: 0
SpecDefMod: 0
SpecAttMod: 0
PhysDefMod: 0
PhysAttMod: 0
Queued Action: Alice using Milk Drink on nothing
StatusProblem: NullStatus
BadPoisonCounter: 0
SleepCounter: 0
cond_flinch: false
cond_confusion: 0
LinePos: 1
Priority: 0
InitiativeOrder: 8
cond_HealBlock: 2
cond_LeechSeed: false
cond_Substitute: 0
cond_LightScreen: 0
cond_Reflect: 0
PokeAbility: Stench
Alignment: Neutral
PokeSpecies: Bulbasaur

What will PC1 (29/29) do?

>use milk drink
okay, PC1 will use Milk Drink on PC1!

What will PC2 (29/29) do?

>use milk drink
okay, PC2 will use Milk Drink on PC2!

What will PC3 (29/29) do?

>use milk drink
okay, PC3 will use Milk Drink on PC3!

What will PC4 (29/29) do?

>use milk drink
okay, PC4 will use Milk Drink on PC4!

Initiative: PC4, PC3, PC2, PC1, Alice, Bob, Carol and Dan.

PC4 uses Milk Drink!
Move accuracy 0.
crit chance level is 0.
PC4 is healed for 0 (100% -> 100%)

PC3 uses Milk Drink!
Move accuracy 0.
crit chance level is 0.
PC3 is healed for 0 (100% -> 100%)

PC2 uses Milk Drink!
Move accuracy 0.
crit chance level is 0.
PC2 is healed for 0 (100% -> 100%)

PC1 uses Milk Drink!
Move accuracy 0.
crit chance level is 0.
PC1 is healed for 0 (100% -> 100%)

== Starting Round 5 ==
     Enemy: Alice     Bob       Carol     Dan       
Your Party: PC1       PC2       PC3       PC4       

What will PC1 (29/29) do?

>activities
That's not a verb I recognise.

What will PC1 (29/29) do?

>rules all
Rules tracing now switched to "all". Type "rules off" to switch it off again.

What will PC1 (29/29) do?

>use bulk up
[Rule "declare everything initially unmentioned rule" applies.]
[Rule "Rule for supplying a missing second noun while using" applies.]
[Rule "announce items from multiple object lists rule" applies.]
[Rule "set pronouns from items from multiple object lists rule" applies.]
[Rule "before stage rule" applies.]
[Rule "Before a pokemon doing something during combat" does not apply (wrong action).]
[Rule "Before a pokemon doing something during combat" does not apply (wrong action).]
[Rule "Before a pokemon doing something during combat" does not apply (wrong action).]
[Rule "Before a pokemon doing something during combat" does not apply (wrong action).]
[Rule "hit yourself in confusion instead rule" does not apply (wrong action).]
[Rule "instead stage rule" applies.]
[Rule "Instead of doing something other than using when combat is happening" does not apply (wrong action).]
[Rule "investigate player's awareness before action rule" applies.]
[Rule "player aware of his own actions rule" applies.]
[Rule "check stage rule" applies.]
[Rule "Check using a pokemove on something during combat" applies.]
[Rule "Check using substitute on something" does not apply (wrong action).]
[Rule "Check someone using leech seed on" does not apply (wrong action).]
[Rule "Check someone using leech seed on" does not apply (wrong action).]
[Rule "carry out stage rule" applies.]
[Rule "Carry out someone using a pokemove on something during combat" does not apply (wrong action).]
[Rule "Carry out using it on during combat" applies.]
okay, PC1 will use Bulk Up on PC1!
[Rule "after stage rule" applies.]

[Rule "investigate player's awareness after action rule" applies.]
[Rule "report stage rule" applies.]
[Rule "last specific action-processing rule" applies.]
[Rule "A first turn sequence rule" applies.]
[Rule "every turn stage rule" applies.]
[Rule "Every turn when coord-test-on is true" does not apply (wrong context).]
[Rule "Combat Round Rule" applies.]
[Rule "A last turn sequence rule" applies.]
[Rule "notify score changes rule" applies.]
What will PC2 (29/29) do?

>use bulk up
[Rule "declare everything initially unmentioned rule" applies.]
[Rule "Rule for supplying a missing second noun while using" applies.]
[Rule "announce items from multiple object lists rule" applies.]
[Rule "set pronouns from items from multiple object lists rule" applies.]
[Rule "before stage rule" applies.]
[Rule "Before a pokemon doing something during combat" does not apply (wrong action).]
[Rule "Before a pokemon doing something during combat" does not apply (wrong action).]
[Rule "Before a pokemon doing something during combat" does not apply (wrong action).]
[Rule "Before a pokemon doing something during combat" does not apply (wrong action).]
[Rule "hit yourself in confusion instead rule" does not apply (wrong action).]
[Rule "instead stage rule" applies.]
[Rule "Instead of doing something other than using when combat is happening" does not apply (wrong action).]
[Rule "investigate player's awareness before action rule" applies.]
[Rule "player aware of his own actions rule" applies.]
[Rule "check stage rule" applies.]
[Rule "Check using a pokemove on something during combat" applies.]
[Rule "Check using substitute on something" does not apply (wrong action).]
[Rule "Check someone using leech seed on" does not apply (wrong action).]
[Rule "Check someone using leech seed on" does not apply (wrong action).]
[Rule "carry out stage rule" applies.]
[Rule "Carry out someone using a pokemove on something during combat" does not apply (wrong action).]
[Rule "Carry out using it on during combat" applies.]
okay, PC2 will use Bulk Up on PC2!
[Rule "after stage rule" applies.]

[Rule "investigate player's awareness after action rule" applies.]
[Rule "report stage rule" applies.]
[Rule "last specific action-processing rule" applies.]
[Rule "A first turn sequence rule" applies.]
[Rule "every turn stage rule" applies.]
[Rule "Every turn when coord-test-on is true" does not apply (wrong context).]
[Rule "Combat Round Rule" applies.]
[Rule "A last turn sequence rule" applies.]
[Rule "notify score changes rule" applies.]
What will PC3 (29/29) do?

>use bulk up
[Rule "declare everything initially unmentioned rule" applies.]
[Rule "Rule for supplying a missing second noun while using" applies.]
[Rule "announce items from multiple object lists rule" applies.]
[Rule "set pronouns from items from multiple object lists rule" applies.]
[Rule "before stage rule" applies.]
[Rule "Before a pokemon doing something during combat" does not apply (wrong action).]
[Rule "Before a pokemon doing something during combat" does not apply (wrong action).]
[Rule "Before a pokemon doing something during combat" does not apply (wrong action).]
[Rule "Before a pokemon doing something during combat" does not apply (wrong action).]
[Rule "hit yourself in confusion instead rule" does not apply (wrong action).]
[Rule "instead stage rule" applies.]
[Rule "Instead of doing something other than using when combat is happening" does not apply (wrong action).]
[Rule "investigate player's awareness before action rule" applies.]
[Rule "player aware of his own actions rule" applies.]
[Rule "check stage rule" applies.]
[Rule "Check using a pokemove on something during combat" applies.]
[Rule "Check using substitute on something" does not apply (wrong action).]
[Rule "Check someone using leech seed on" does not apply (wrong action).]
[Rule "Check someone using leech seed on" does not apply (wrong action).]
[Rule "carry out stage rule" applies.]
[Rule "Carry out someone using a pokemove on something during combat" does not apply (wrong action).]
[Rule "Carry out using it on during combat" applies.]
okay, PC3 will use Bulk Up on PC3!
[Rule "after stage rule" applies.]

[Rule "investigate player's awareness after action rule" applies.]
[Rule "report stage rule" applies.]
[Rule "last specific action-processing rule" applies.]
[Rule "A first turn sequence rule" applies.]
[Rule "every turn stage rule" applies.]
[Rule "Every turn when coord-test-on is true" does not apply (wrong context).]
[Rule "Combat Round Rule" applies.]
[Rule "A last turn sequence rule" applies.]
[Rule "notify score changes rule" applies.]
What will PC4 (29/29) do?

* * *

PRD
An Interactive Fiction by func_door
Release 1 / Serial number 140918 / Inform 7 build 6L02 (I6/v6.33 lib 6/12N) SD

Staging Area
You can see PC2, PC3 and PC4 here.

>nor
That's not a verb I recognise.

>north
Test Chamber
Obvious exits: south

>north
You can't go that way.

Obvious exits: south

>down
Dungeon Entrance
Obvious exits: east south

>north
You can't go that way.

Obvious exits: east south

>south
Jumble
Obvious exits: north

>east
You can't go that way.

Obvious exits: north

>west
You can't go that way.

Obvious exits: north

>west
You can't go that way.

Obvious exits: north

>north
Dungeon Entrance
Obvious exits: east south

>south
Jumble
Obvious exits: north

>west
You can't go that way.

Obvious exits: north

>south
You can't go that way.

Obvious exits: north

>north
Dungeon Entrance
Obvious exits: east south

>east
Tunnel
Obvious exits: north east west south

>west
Dungeon Entrance
Obvious exits: east south

>west
You can't go that way.

Obvious exits: east south

>east
Tunnel
Obvious exits: north east west south

>north
Maze
Obvious exits: north east south

* * *

>north
Test Chamber
You can see Alice, Bob, Carol and Dan here.

Beginning combat!

     Enemy: Alice     Bob       Carol     Dan       
Your Party: PC1       PC2       PC3       PC4       

What will PC1 (36/36) do?

>verbose combat
Enabling verbose combat.

What will PC1 (36/36) do?

>use toxic on alice
okay, PC1 will use Toxic on Alice!

What will PC2 (36/36) do?

>use toxic on bob
okay, PC2 will use Toxic on Bob!

What will PC3 (29/29) do?

* * *

>use toxic on carol
okay, PC3 will use Toxic on Carol!

What will PC4 (29/29) do?

>use toxic on dan
okay, PC4 will use Toxic on Dan!

Initiative: PC2, PC1, PC4, PC3, Alice, Bob, Carol and Dan.

PC2 uses Toxic on Bob!
Move accuracy 0.
crit chance level is 0.
Bob is inflicted with BadPoisoned!

PC1 uses Toxic on Alice!
Move accuracy 0.
crit chance level is 0.
Alice is inflicted with BadPoisoned!

PC4 uses Toxic on Dan!
Move accuracy 90, modified by accuracy 0 and evasion 0 is 90.
crit chance level is 0.
Dan is inflicted with BadPoisoned!

PC3 uses Toxic on Carol!
Move accuracy 90, modified by accuracy 0 and evasion 0 is 90.
crit chance level is 0.
Carol is inflicted with BadPoisoned!

Alice uses Bite on PC2!
Move accuracy 100, modified by accuracy 0 and evasion 0 is 100.
crit chance level is 0.
calculating core damage with attack 8, defense 21, power 60.
before modifiers: 3.
modified by type effectiveness: 3.
modified by random variation: 2.
PC2 is damaged for 2 (100% -> 94%)

Bob uses Bite on PC2!
Move accuracy 100, modified by accuracy 0 and evasion 0 is 100.
crit chance level is 0.
calculating core damage with attack 8, defense 21, power 60.
before modifiers: 3.
modified by type effectiveness: 3.
modified by random variation: 3.
PC2 is damaged for 3 (94% -> 86%)
PC2 is inflicted with Flinching!

Carol uses Bite on PC2!
Move accuracy 100, modified by accuracy 0 and evasion 0 is 100.
crit chance level is 0.
calculating core damage with attack 8, defense 21, power 60.
before modifiers: 3.
modified by type effectiveness: 3.
modified by random variation: 3.
PC2 is damaged for 3 (86% -> 78%)

Dan uses Bite on PC2!
Move accuracy 100, modified by accuracy 0 and evasion 0 is 100.
crit chance level is 0.
calculating core damage with attack 8, defense 21, power 60.
before modifiers: 3.
modified by type effectiveness: 3.
modified by random variation: 3.
PC2 is damaged for 3 (78% -> 69%)
PC2 is inflicted with Flinching!

Alice dissolves from strong poison!
Alice is damaged for 1 (100% -> 94%)
Bob dissolves from strong poison!
Bob is damaged for 1 (100% -> 94%)
Carol dissolves from strong poison!
Carol is damaged for 1 (100% -> 94%)
Dan dissolves from strong poison!
Dan is damaged for 1 (100% -> 94%)

== Starting Round 2 ==
     Enemy: Alice     Bob       Carol     Dan       
Your Party: PC1       PC2       PC3       PC4       

What will PC1 (36/36) do?

* * *

PRD
An Interactive Fiction by func_door
Release 1 / Serial number 140918 / Inform 7 build 6L02 (I6/v6.33 lib 6/12N) SD

Staging Area
You can see PC2, PC3 and PC4 here.

>transform into venusaur
You can't see any such thing.

* * *

>showme self
yourself - Player Character
location: in Staging Area
singular-named, proper-named; unlit, inedible, portable; male; ready-for-orders
printed name: "PC1"
printed plural name: "Player Characters"
indefinite article: none
description: "As good-looking as ever."
initial appearance: none
carrying capacity: 100
Ability Slot: 1
Third Type: NoType
Second Type: PoisonType
First Type: GrassType
Level: 10
Current Hit Points: 36
EvadeMod: 0
AccMod: 0
SpeedMod: 0
SpecDefMod: 0
SpecAttMod: 0
PhysDefMod: 0
PhysAttMod: 0
Queued Action: the your former self waiting
StatusProblem: NullStatus
BadPoisonCounter: 0
SleepCounter: 0
cond_flinch: false
cond_confusion: 0
LinePos: 1
Priority: 0
InitiativeOrder: 0
PokeAbility: Stench
Alignment: Friendly
PokeSpecies: Venusaur
Experience: 0
SXP: 0
SDXP: 0
PDXP: 0
SAXP: 0
PAXP: 0
HPXP: 0

>north
Test Chamber
You can see Alice, Bob, Carol and Dan here.

Beginning combat!

     Enemy: Alice     Bob       Carol     Dan       
Your Party: PC1       PC2       PC3       PC4       

What will PC1 (36/36) do?

>use toxic on alice
okay, PC1 will use Toxic on Alice!

What will PC2 (29/29) do?

* * *

>use toxic on carol
okay, PC3 will use Toxic on Carol!

What will PC4 (29/29) do?

>use toxic on dan
okay, PC4 will use Toxic on Dan!

Initiative: PC1, PC4, PC3, PC2, Alice, Bob, Carol and Dan.

PC1 uses Toxic on Alice!
Alice is inflicted with BadPoisoned!

PC4 uses Toxic on Dan!
Dan is inflicted with BadPoisoned!

PC3 uses Toxic on Carol!
Carol is inflicted with BadPoisoned!

PC2 uses Toxic on Bob!
Bob is inflicted with BadPoisoned!

Alice uses Bite on PC2!
PC2 is damaged for 3 (100% -> 90%)

Bob uses Bite on PC2!
PC2 is damaged for 3 (90% -> 79%)

Carol uses Bite on PC2!
PC2 is damaged for 3 (79% -> 69%)

Dan uses Bite on PC2!
PC2 is damaged for 4 (69% -> 55%)

Alice dissolves from strong poison!
Alice is damaged for 1 (100% -> 94%)
Bob dissolves from strong poison!
Bob is damaged for 1 (100% -> 94%)
Carol dissolves from strong poison!
Carol is damaged for 1 (100% -> 94%)
Dan dissolves from strong poison!
Dan is damaged for 1 (100% -> 94%)

== Starting Round 2 ==
     Enemy: Alice     Bob       Carol     Dan       
Your Party: PC1       PC2       PC3       PC4       

What will PC1 (36/36) do?